10
10
20	20	20	20	20	20	20	20	20	20
20	1	1	1	1	1	1	1	1	20
20	1	1	1	1	1	1	1	1	20
20	3	1	1	1	1	21	1	1	20
20	1	1	1	1	1	1	1	1	20
20	1	21	1	1	1	2	1	1	20
20	1	1	1	1	1	1	1	1	20
20	1	1	1	1	1	1	1	1	20
20	1	3	1	1	1	1	21	1	20
20	20	20	20	20	20	20	20	20	20